#########################################
#                                       #
#                                       #
#                                       #
#    ####                       ####    #
#    ####                       ####    #
#    ####                       ####    #
#                                       #
#            ####       ####            #
#            ####   P   ####            #
#            ####       ####            #
#                                       #
#    ####                       ####    #
#    ####                       ####    #
#    ####                       ####    #
#                                       #
#                                       #
#                                       #
#########################################
